11  2222222  11
111  22222  111 
111   222   111
0000       0000 
111   000   111
111  00000  111
11  0000000  11